12 12
8 3
2 4
1 1 1 1 1 1 1 1 1 1 1 1 
1 1 1 0 0 0 1 1 1 1 1 1
1 1 0 0 1 0 0 0 0 1 1 1
1 1 0 3 2 1 1 1 0 1 1 1
1 1 0 3 0 3 0 1 0 1 1 1
1 1 0 3 0 3 0 1 0 1 1 1
1 1 0 3 0 3 0 1 0 1 1 1
1 1 0 1 2 1 1 1 0 1 1 1
1 1 0 1 0 0 0 0 0 1 1 1
1 1 0 0 0 1 1 1 1 1 1 1
1 1 1 1 1 1 1 1 1 1 1 1
1 1 1 1 1 1 1 1 1 1 1 1