12 12
6 4
4 6
1 1 2 2 2 3 1 1 2 2 2 2
1 1 1 2 2 3 1 1 1 1 2 2
1 1 1 2 2 3 1 1 1 1 1 1
1 1 1 2 2 3 3 3 3 3 3 3
3 3 3 3 1 0 1 1 1 1 1 1
3 3 3 3 1 0 1 1 1 1 1 1
3 3 3 3 1 0 1 1 1 1 1 1
3 3 3 3 2 0 1 1 1 1 1 1
3 3 3 3 2 1 1 1 1 1 1 2
1 1 1 1 1 1 1 1 1 1 2 3
1 1 1 1 1 1 1 1 1 2 3 3
1 1 1 1 1 1 1 1 2 3 3 3